10 10
XXXXXXXXXX
X   I X  X
XXX XXX  X
X I I X  X
XXXIXXX  X
I        X
I        X
XXX XXXX X
X I I X  X
XXXXXXXXXX
Guard
1 8 asdw
Key
1 3 4 3 0
Lever
8 7 5 0 1 6 0 1
Hero
1 1 0
