10 10
XXXXXXXXXX
X     X  X
XXX XXX  X
X     X  X
XIX XXX  X
I        X
X        X
X        X
X        X
XXXXXXXXXX
Ogre
1 8
Key
5 1 5 0 1 4 1 0
Hero
1 1 1
